1 4 15 3 3 0 -1 0 -1
1 5 15 3 4 0 -1 0 -1
2 8 15 4 2 0 -1 0 -1
2 1 15 5 2 0 -1 0 -1
3 5 15 3 1 0 -1 0 -1
3 7 15 3 0 0 -1 0 -1
4 5 15 2 2 0 -1 0 -1
4 6 15 1 2 0 -1 0 -1
6 5 10 0 0 0 -1 0 -1
6 2 10 1 0 0 -1 0 -1
6 6 10 2 0 0 -1 0 -1
6 8 10 4 0 0 -1 0 -1
6 0 10 5 0 0 -1 0 -1
6 2 10 6 0 0 -1 0 -1
6 4 10 0 1 0 -1 0 -1
6 1 10 6 1 0 -1 0 -1
6 1 10 0 2 0 -1 0 -1
6 7 10 6 2 0 -1 0 -1
6 6 10 0 3 0 -1 0 -1
6 3 10 6 3 0 -1 0 -1
6 7 10 0 4 0 -1 0 -1
6 2 10 1 4 0 -1 0 -1
6 4 10 2 4 0 -1 0 -1
6 2 10 4 4 0 -1 0 -1
6 1 10 5 4 0 -1 0 -1
6 1 10 6 4 0 -1 0 -1
