1 6 15 3 3 0 -1 0 -1
1 6 15 4 2 0 -1 0 -1
1 9 15 3 1 0 -1 0 -1
1 9 15 2 2 0 -1 0 -1
1 1 15 3 2 0 -1 0 -1
1 3 15 2 1 0 -1 0 -1
1 7 15 4 1 0 -1 0 -1
1 5 15 2 3 0 -1 0 -1
1 1 15 4 3 0 -1 0 -1
1 4 15 5 3 0 -1 0 -1
2 7 15 1 1 0 -1 0 -1
